000000000000000000000000000000000000000000
000000000000000000000000000000000000000000
000000000000000000000000000000900000000000
000000002200000000000000000111111000000000
000000000000000000000000000000000000000000
000022000000000000000000000000000000000000
000000000000000000000000000000000000000000
000000002200000000000000000000000000000000
000000000000000000000000000000000000000000
000002222000000000000000000000000000000000
000000002220000000000000000000000000000000
000000000022220000000000000000000000000000
000000000000022222200000000000000000000000
000000000000000000222220000000000000000000
000000000000000000000022222200000000000000
000000000000000000000000000022200000000000
000000000000000000000000000000000000000000
000000000000000000000000000000000022220000
000000000000000000000000000000002220000000
000000000000000000000000000000222000000000
000000000000000000000000000022200000000000
000000000000000000000000022220000000000000
000000000000000000000022220000000000000000
000000000000000000022220000000000000000000
000000000000000022220000000000000000000000
000000000000022220000000000000000000000000
000000000022220000000000000000000000000000
000000022220000000000000000000000000000000
000022220000000000000000000000000000000000
0xy000000000000000000000000000000000000000
222222222222222222222222222222222222222222
