000000000000000000000000000000000000000000
000000000000000000000000000000000000000000
000000000000000000000000000000000000000000
000000000000000000000000000000000000000000
000000000000000000000000000000000000000000
000000000000000000000111111000000000000000
000000000000000000000000000000000000000000
000000000000000000000000000000000000000000
000000000000000000000000000000000000000000
000000000000000000000000000000000000000000
000000000000000000000000000000000000000000
000000000000000000000000000000000000000002
000000000000000000000000000000000000000000
000000000000000000000000000000000000000000
000000000000001111110000000000000000000000
000000000000000000000000000000000000000000
000000000000000000000000000002211110000000
000000000000000000000000000000000000000000
000000000000000000000000000000000000000000
000000000000000000000000000000000000000000
000000000000000000000000000000000000000000
000000000000000000000000000000000000000000
000000000000001111220000000000000000000000
000000000000001000220000000000000000000000
000000000000001000110000000000000000000000
000000000000011000110000000000000000000000
000000000001110000000000020000000000000000
000000000000000000000000000000000000000000
000000000000000000000000000002000000000000
000000000000000000000000000000002000000000
222222222222222222222223333333333222222222
