00000000000000000000000000000000000000000000000000000000000000000
00000000000000000000000000000000000000000000000000000000000000000
00000000000000000000000000000000000000000000000000000000000000000
00000000000000000000000000000000000001111111111111111111111110000
00000000000000000000000000000000000000000000000000000000000000000
00000000000000000011111111000000000000000000000000000000000000000
00000000000000000000000000000000000000000000000000000000000000000
00000000000000000000000000000000000000000000000000000000000000000
00000000000000000000000000000000000000000000000000000000000000000
00000000000000000000000000000000000000000000000000000000000000000
00000000001111111111111111111111111110000000000000000000000000000
00000000000000000000000000000000000010000000000000000000000000000
00000000000000000000000000000000000011000000000000000000000000000
00000000000000000000000000000000000001111000000000000000000000000
00000000000000000000000000000000000000000000000000000000000000000
00000000000000000000011111111111111111111111111110000000000000000
00000000000000000000000000000000000000000000000000000000000000000
00000000000000000000000000000000000000000000000000000000000000000
00000000000000000000000000000000000000000000000000000000000000000
00000011111111111111111100000000000000000000000000000000000000000
00000000000000000000000000000000000000000000000000000000000000000
00000000000000000000000000000000000000000000000000000000000000000
